18 13
w w w w w w w w w w w w w w w w w w
w f f f f f f f f f f h f f f t t w
w f s f f f f f f f f h f f f t t w
w f f f f f f f f f f h f f f t t w
w f f f f f f f f f f h f f f t t w
w f s f f f f f f f f h f f f t t w
w f f f f f f f f f f h f f f f f w
w f f f f f f f f f f h f f f f f w
w f f f f f f f f f f h f f f f f w
w f f f f f f f f f f h h h h f h w
w f f f f f f f f f f f f f f f f w
w f f f f f f f f f f f f f f f f w
w w w w w w w w w w w w w w w w w w
s 2 2 11 2
s 2 5 11 5
b 3 2 b1
b 5 2 b2
b 3 4 b3
b 5 4 b4
b 3 6 b5
b 5 6 b6
b 3 8 b7
b 5 8 b8
b 3 10 b9
b 5 10 b10
p 1 1 2 p1
p 1 8 2 p2
p 1 3 2 p3
p 1 5 2 p4
p 1 4 2 p5
p 1 2 2 p6
p 1 7 2 p7
p 1 6 2 p8