18 13
w w w w w w w w w w w w w w w w w w
w w t t t w w w w w w w w w w w w w
w t t t t t w w f f f w w w w f f w
w t f t f t h f f f f f f f s f f w
w t f f f t w w f f f f f f f f f w
w w f f f w w w w f f f f w w f f w
w w w f w w w w w w f f f w w f f w
w w w f w w w w w w w f f f f f f w
w f f f f f w w w w w w f f f f f w
w f f f f f f f f f f f f f f f f w
w f f f f f f f f f f f f f f f f w
w f f f f f w w w w w w w w w w w w
w w w w w w w w w w w w w w w w w w
s 14 3 6 3
b 2 3 b1
b 2 9 b2
b 3 9 b3
b 2 10 b4
b 3 10 b5
b 13 4 b6
b 14 4 b7
b 12 5 b8
b 12 6 b9
b 14 8 b10
b 15 8 b11
b 14 9 b12
b 15 9 b13
p 1 2 2 p1
p 2 2 2 p2
p 3 2 2 p3
p 1 3 2 p4
p 3 3 2 p5
p 1 4 2 p6
p 2 4 2 p7
p 3 4 2 p8