18 13
w w w w w w w w w w w w w w w w w w
w f f f f f f f f f f f f f f f f w
w f f f h f f f f f f f h f f f f w
w f f f h f f f f f f f h f t f f w
w f f f h f f f f f f f h f t f f w
w f f f h f f f f f f f h f t f f w
w f f f f f f f f f f f f f f f f w
w f f f h f t f f f f f h f f f f w
w f f f h f t f f f f f h f f f f w
w f f f h f t f f f f f h f f f f w
w f f f h f t f f f f f h t t f f w
w f f f f f f f f f f f f f f f f w
w w w w w w w w w w w w w w w w w w
b 9 2 b1
b 9 3 b2
b 9 4 b3
b 9 5 b4
b 9 6 b5
b 9 7 b6
b 9 8 b7
b 9 9 b8
b 9 10 b9
p 1 1 2 p1
p 1 8 2 p2
p 1 3 2 p3
p 1 5 2 p4
p 1 4 2 p5
p 1 2 2 p6
p 1 7 2 p7
p 1 6 2 p8