18 13
w w w w w w w w w w w w w w w w w w
w w w w w w w w w w w w w w w w w w
w w w w w w w w w w w w w w w w w w
w t f f f f f f f f f f t w w w w w
w f f f f f h f f f f f f w w w w w
w f f f h f f f h f h f w w w w w w
w f h f f f f f f f f f f w w w w w
w f f f f f h f h f f h f w h h h w
w f f h f f f f f f h f f w h w w w
w t f f f f f f f f f f t w h h h w
w w w w w w w w w w w w w w h w w w
w w w w w w w w w w w w w w h h h w
w w w w w w w w w w w w w w w w w w
b 3 7 b1
b 7 6 b2
b 9 4 b3
b 8 8 b4
p 3 3 2 p1
p 6 3 2 p2
p 8 3 2 p3
p 10 3 2 p4
p 3 9 2 p5
p 6 9 2 p6
p 8 9 2 p7
p 10 9 2 p8